.....#...........##.....................
#..........#........#.............#.....
....................#.#...........#.#...
..#................#..#.....#...........
.#.......#.........................#....
....#..........................#.......#
....#.#.......#....#............#.......
.#...#...............#..........#.......
.........#..#...........................
.............#....#..................#..
.##....#.##........#...#......#.........
...#..............#.......#.............
...##.................#...#...........#.
...........................#..#.....#...
...........................#............
...........#......#...##................
..#.#......#...........#..#...........##
....#....................#..............
......#...#...##.....#......#...........
.....................#.....#..........#.
....#....#.##...........................
.....#...............#..........#......#
.......#..#.....#............#....#.#..#
.........#...#.#........................
...........#......#............#........
.....................##.....#......#....
......#.................................
...##...............#..............#....
#....#.....#...#........................
....#...........#................#......
.#.#..#.........#.#.....................
........#....#....#.....................
.........#..........#...##..............
#..#...................#............###.
............#..............#............
........................#............#..
#.....#...........#....................#
#............#..#........#......##......
....#.............#..#............#.....
.....................#......#...........
