........
........
.##...#.
#....##.
.####...
........
\robot 2 4
\robot 3 2
\robot 4 0